1111111111111111111111111111111111
1E0000000000000C00000C000001110001
1010011111100000111111111111010111
1111110010111111101001000000011101
1P0000000C00C0000000000000000000C1
1111111111111111111111111111111111