1111111111111111111111111111111111
1E0000000000000C00001C000010000001
1010010100100000101111011110010101
1010010010101010001111110000010101
1P0000000C00C0000000000000000000C1
1111111111111111111111111111111111