1111111111111111111111111111111111
1E0001000000000C00000C000000000001
1010010100100000111001000000010101
1111110010111111101001000000010101
1P0000000C01C0000010000000000000C1
1111111111111111111111111111111111