1111111111111111111111111111111
11111011C11011011011011C1101111
1111101101101101101101101101111
1111101101101101101101101101111
1000000000000000000000000C00001
1P00000C000000C00000C00000000E1
10000000000C0000000000000000001
1111101101101101101101101101111
1111101101101101101101101101111
11111C11011011011C11011011C1111
1111111111111111111111111111111