1111111111111111111111111111111
11111011C11011011011011C1101111
1111101101101101101101101101111
1111101101101101101101101101111
100G000000000000000000000C000G1
1P00000C000000C00000C00000000E1
1000000G000C0000G00000000000001
1111101101101101101101101101111
1111101101101101101101101101111
11111C11011011011C11011011C1111
1111111111111111111111111111111
