1111111111111
10G10000000C1
100C011111G01
1P0G11E000C01
1111111111111