1111111111111
10010000000C1
100100E000001
1P00000000001
1111111111111